11111111111111111111
1S100000010000001001
10111101010111101011
10100001000000100001
10101111011110111111
10001000010010000001
11111011011011111101
10100001000010000001
10101111111010111111
10000010000000000001
11111010111111111101
10000010100101000001
11011110110101111111
10000010100000000001
11010110001011111101
10010010101000100001
11011110101110111011
11010100100000101011
100001101101100010F1
11111111111111111111
