11111111111111111111
1S101101000100000001
10000001011101101111
11101101010001001001
10001001010011001001
11101000000001101101
10101100101000100101
10000001101100000001
11111011000111111111
10000000010000000001
10111110000110111101
10000000101100000001
11111010101000111111
10101010100010010001
10101011111111110101
10000000010000010111
11110100110100110001
10100110010110010101
100001000001000001F1
11111111111111111111
