11111111111111111111
1S001000000000000001
10001000000000000001
10001000000000000001
10001000000000000001
10001000000000000001
11111000000000000001
10000000000000000001
10000000000000000001
10000000000000000001
10000000000000000001
10000000000000000001
10000000000000000001
10000000000000000001
10000000000000000001
10000000000000000001
10000000000000000001
10000000000000000001
100000000000000000F1
11111111111111111111
