11111111111111111111
1S000000000000000001
10000100010001010001
10001000000000000001
10000010001010111001
10010010010000010001
10000000000001000001
10010101111011111001
10100000000100100101
10011000000101000101
10000001011000000111
10100101100010100001
10100011000010010001
11000100010101000101
10010000000000100001
10000101101010111001
11100110010010000101
10010000101100101001
101000101000100000F1
11111111111111111111
