11111111111111111111
1S000000000000000001
10111111111000010011
10100000100000100101
10100001000001001001
10100010000010010001
10100110000100100101
10101001001001001001
10110000110010010011
10100000100100100101
10100001001001001001
10000010010010010001
10000100100100100101
10001001001001001001
10010010010010010011
10100100100100100101
11001001001001001001
10010010010010010001
100001000001000001F1
11111111111111111111
