11111111111111111111
1S100000000000000001
10100000000000000001
10111110000000000001
10000010000000000001
10000110000000000001
11111000000000000001
10000000000000000001
10000000000000000001
10000000000000000001
10000000000000000001
10000000000000000001
10000000000000000001
10000000000000000001
10000000000000000001
10000000000000000001
10000000000000000001
10000000000000000001
100000000000000000F1
11111111111111111111
